E E E E E E E E E E E E E E E E E E E E E E E E E E E E E E E E E E E E E E E E E E E E E E E E E E E E E E E E E E E E E E E E E E E E E E E E E E E 
E E E E E E E E E E E E E E E E E E E E E E E E E E E E E E E E E E E E E E E E E E E E E E E E E E E E E E E E E E E E E E E E E E E E E E E E E E E 
E E E E E E E E E E E E E E E E E E E E E E E E E E E E E E E E E E E E E E E E E E E E E E E E E E E E E E E E E E E E E E E E E E E E E E E E E E E 
E E E E E E E E E E E E E E E E E E E E E E E E E E E E E E E E E E E E E E E E E E E E E E E E E E E E E E E E E E E E E E E E E E E E E E E E E E E 
E E E E E E E E E E E E E E E E E E E E E E E E E E E E E E E E E E E E E E E E E E E E E E E E E E E E E E E E E E E E E E E E E E E E E E E E E E E 
E E E E E E E E E E E E E E E E E E E E E E E E E E E E E E E E E E E E E E E E E E E E E E E E E E E E E E E E E E E E E E E E E E E E E E E E E E E 
E E E E E E E E E E W W W W W W W W W E E E E E E E E E E E E E E E E E E E E E E E E E E E E E E E E E E E E E E E E E E E E E E E E E E E E E E E E 
E E E E E E E E E E W F F F F F F F W E E E E E E E E E E E E E E E E E E E E E E E E E E E E E E E E E E E E E E E E E E E E E E E E E E E E E E E E 
E E E E E E E E E H D F F F F F F F W E E E E E E E E E E E E E E E E E E E E E E E E E E E E E E E E E E E E E E E E E E E E E E E E E E E E E E E E 
E E E E E E E E E H W F F F F F F F W E E E E E E E E E E E E E E E E E E E E E E E E E E E E E E E E E E E E E E E E E E E E E E E E E E E E E E E E 
E E E E E E E E E H W W W W W W W W W E E E E E E E E E E E E E E E E E E E E E E E E E E E E E E E E W W W W W W W W E E E E E E E E E E E E E E E E 
E E E E E E E E E H H H H H H H H H H H H H H H H H H H H E E E E E E E E E E E E E E E E E E E E E E W F F F F F F W E W W W W W W W W W W W W W E E 
E E E E E E E E E E H E E E E E E E E E E E E E E E E E H E E E E E E E E E E E E E E E E E E E E E H D F F F F F F W E W F F F F F F F F F F F W E E 
E E E E E E E E E E H E E E E E E E E E E E E E E E E E H E E E E E E E E E E E E E E E E E E E E E H W F F F F F F W E W F F F F F F F F F F F W E E 
E E E E E E E E E H H E E E E E E E E E E E E E E E E E H E E E E E E E E E E E E E E E E E E E E E H W F F F F F F W E W F F F F F F F F F F F W E E 
E E E E E E E E E H W W W W W W W E E E E E E E E E E E H E E E E E E E E E E E E E E E E E E E E E H W F F F F F F W E W F F F F F F F F F F F W E E 
E E E E E E E E E H W F F F F F W E E E E E E E E E E E H E E E E E E E E E E E E E E E E E E E E E H W F F F F F F W E W F F F F F F F F F F F W E E 
E E E E E E E E E H W F F F F F W E E E E E E E E E E E H E E E E E E E E E E E E E E E E E E E E E H W F F F F F F W E W F F F F F F F F F F F W E E 
E E E E E E E E E H W F F F F F W E E E E E E E E E E E H W W W W W W W W W W W W W W W W E E E E E H W F F F F F F W E W F F F F F F F F F F F W E E 
E E E E E E E E E H W F F F F F W E E E E E E E E E E E H W F F F F F F F F F F F F F F W E E E E E H W F F F F F F W E W F F F F F F F F F F F W E E 
E E E E E E E E E H W F F F F F W E E E E E E E E E E E H W F F F F F F F F F F F F F F W E E E E E H W F F F F F F W E W W W W W W W W W W D W W E E 
E E E E E E E E E H W F F F F F W E E E E E E E E E E E H W W W W W W W W W W W D W W W W E E E E E H W F F F F F F W H H H H H H H H H H H H E E E E 
E E E E E E E E E H W F F F F F W E E E E E E E E E E E H H H H H H H H H H H H H H H H H H H H H H H W F F F F F F W H E E E E E E E E E E H E E E E 
E E E E E E E E E H D F F F F F W E E E E E E E E E E E H E E E E E E E E E E E E E H E E E E E E E H W F F F F F F W H E E E E E E E E E E H E E E E 
E E E E E E E E E E W F F F F F W E E E E E E E E E E E H E E E E E E E E E E E E E H E E E E E E E H W F F F F F F W H E E E E E E E E E E H E E E E 
E E E E E E E E E E W F F F F F W E E E E E E E E E E E H E E E E E E E E E E E E E H E E E E E E E H W W W W W W W W H E E E E E E E E E E H E E E E 
E E E E E E E E E E W F F F F F W E E E E E E E E E E E H E E E E E E E E E E E E E H E E E E E E E H H H H H H H H H H E E E E E E E E E E H E E E E 
E E E E E E E E E E W F F F F F W E E E E E E E H H H H H E E E E E E E E E E E E E H E E E E E E E E E E E E E E E E E E E E E E E E E E E H E E E E 
E E E E E E E E E E W W W W W W W E E E E E E E H W W W W W W W E E E E E E E E E E H E E E E E E E E E E E E E E E E E E E E E E E E E E E H E E E E 
E E E E E E E E E E E E E E E E E E E E E E E E H W F F F F F W E E E E E E E E E E H E E E E E E E E E E E E E E E E E E E E E E E E E E E H E E E E 
E E E E E E E E E E E E E E E E E E E E E E E E H W F F F F F W E E E E E E E E E E H E E E E E E E E E E E E E E E E E E E E E E E E E E E H E E E E 
E E E E E E E E E E E E E E E E E E E E E E E E H W F F F F F W E E E E E E E E E E H E E E E E E E E E E E E E E E E E E E E E E E E E E E H E E E E 
E E E E E E E E E E E E E E E E E E E E E E E E H W F F F F F W E E E E E E E E E E H E W W W W W W W W W W W W W W W E E E E E E E E E E E H H H H H 
E E E E E E E E E E E E E E E E E E E E E E E E H W F F F F F W E E E E E E E E E E H E W F F F F F F F F F F F F F W E E E E E E E E E E W W W W W H 
E E E E E E E E E E E E E E E E E E E E E E E E H W F F F F F W E E E E E E E E E E H E W F F F F F F F F F F F F F W E E E E E E E E E E W F F F W H 
E E E E E E E E E E E E E E E E E E E E E E E E H D F F F F F W E E E E E E E E E E H E W F F F F F F F F F F F F F W E E E E E E E E E E W F F F W H 
E E E E E E E E E E E E E E E E E E E E E E E E E W F F F F F W E E E E E E E E E E H E W F F F F F F F F F F F F F W E E E E E E E E E E W F F F W H 
E E E E E E E E E E E E E E E E E E E E E E E E E W F F F F F W E E E E E E E E E E H E W F F F F F F F F F F F F F W E E E E E E E E E E W F F F W H 
E E E E E E E E E E E E E E E E E E E E E E E E E W F F F F F W E E E E E E E E E E H H D F F F F F F F F F F F F F W E E E E E E E E E E W F F F W H 
E E E E E E E E E E E E E E E E E E E E E E E E E W F F F F F W E E E E E E E E E E H E W F F F F F F F F F F F F F W E E E E E E E E E E W F F F D H 
E E E E E E E E E E E E E E E E E E E E E E E E E W F F F F F W E E E E E E E E E E H E W F F F F F F F F F F F F F W E E E E E E E E E E W F F F W E 
E E E E E E E E E E E E E E E E E E E E E E E E E W F F F F F W E E E E E E E E E E H E W F F F F F F F F F F F F F W E E E E E E E E E E W F F F W E 
E E E E E E E E E E E E E E E E E E E E E E E E E W W W W W W W E E E E E E E E E E H E W F F F F F F F F F F F F F W E E E E E E E E E E W W W W W E 
E E E E E E E E E E E E E E E E E E E E E E E E E E E E E E E E E E E E E E E E E E H E W W W W W W W W W W W W W W W E E E E E E E E E E E E E E E E 
E E E E E E E E E E E E E E E E E E E E E E E E E E E E E E E E E E E E E E E E E E H E E E E E E E E E E E E E E E E E E E E E E E E E E E E E E E E 
E E E E E E E E E E E E E E E E E E E E E E E E E E E E E E E E E E E E E E E E E E H E E E E E E E E E E E E E E E E E E E E E E E E E E E E E E E E 
E E E E E E E E E E E E E E E E E E E E E E E E E E E E E E E E E E E E E E E E E E H E E E E E E E E E E E E E E E E E E E E E E E E E E E E E E E E 
E E E E E E E E E E E E E E E E E E E E E E E E E E E E E E E E E E E E E E E E E E H E E E E E E E E E E E E E E E E E E E E E E E E E E E E E E E E 
E E E E E E E E E E E E E E E E E E E E E E E E E E E E E E E E E E E E E E E E E E H E E E E E E E E E E E E E E E E E E E E E E E E E E E E E E E E 
E E E E E E E E E E E E E E E E E E E E E E E E E E E E E E E E E E E E E E E E E E H H E E E E E E E E E E E E E E E E E E E E E E E E E E E E E E E 
E E E E E E E E E E E E E E E E E E E E E E E E E E E E E E E E E E E E E E W W W W W H E E E E E E E E E E E E E E E E E E E E E E E E E E E E E E E 
E E E E E E E E E E E E E E E E E E E E E E E E E E E E E E E E E E E E E E W F F F W H E E E E E E E E E E E E E E E E E E E E E E E E E E E E E E E 
E E E E E E E E E E E E E E E E E E E E E E E E E E E E E E E E E E E E E E W F F F W H E E E E E E E E E E E E E E W W W W W W W W E E E E E E E E E 
E E E E E E E E E E E E E E E E E E E E E E W W W W W W W W E E E E E E E E W F F F W H E E E E E E E E E E E E E E W F F F F F F W E E E E E E E E E 
E E E E E E E E E E E E E E E E E E E E E E W F F F F F F W E E E E E E E E W F F F W H E E E E E E E E E E E E E E W F F F F F F W E E E E E E E E E 
E E E E E E E E E E E E E E E E E E E E E E W F F F F F F W E E E E E E E E W F F F W H E E E E E E E E E E E E E E W F F F F F F W E E E E E E E E E 
E E E E E E E E E E E E E E E E E E E E E E W F F F F F F D H H H H H H H H W F F F W H E E E E E E E E E E E E E E W F F F F F F W E E E E E E E E E 
E E E E E E E E E E E E E E E E E E E E E E W F F F F F F W E E E E E E E H W F F F W H H H H H H H H H H H H H H H W W W D W W W W E E E E E E E E E 
E E E E E E E E E E E E E E E E E E E E E E W F F F F F F W E E E E E E E H W F F F D H E E E E E E E E E E E E E H H H H H E E E E E E E E E E E E E 
E E E E E E E E E E E E E E E E E E E E E E W F F F F F F W E E E E E E E H W F F F W H E E E E E E E E E E E E E E E E E H E E E E E E E E E E E E E 
E E E E E E E E E E E E E E E E E E E E E E W F F F F F F W E E E E E E E H W W W W W H E E E E E E E E E E E E E E E E E H E E E E E E E E E E E E E 
E E E E E E E E E E E E E E E E E E E E E E W F F F F F F W E E E E E E E H H H H H H H E E E E E E E E E E E E E E E E E H E E E E E E E E E E E E E 
E E E E E E E E E E E E E E E E E E E E E E W F F F F F F W E E E E E E E E E E E E E E E E E E E E E E E E E E E E E E E H E E E E E E E E E E E E E 
E E E E E E E E E E E E E E E E E E E E E E W F F F F F F W E E E E E E E E E E E E E E E E E E E E E E E E E E E E E E E H E E E E E E E E E E E E E 
E E E E E E E E E E E E E E E E E E E E E E W F F F F F F W E E E E E E E E E E E E E E E E E E E E E E E E E E E E E E E H H H E E E E E E E E E E E 
E E E E E E E E E E E E E E E E E E E E E E W W W W W W W W E E E E E E E E E E E E E E E E E E E E E E E E E E E W W W W W W D W W E E E E E E E E E 
E E E E E E E E E E E E E E E E E E E E E E E E E E E E E E E E E E E E E E E E E E E E E E E E E E E E E E E E E W F F F F F F F W E E E E E E E E E 
E E E E E E E E E E E E E E E E E E E E E E E E E E E E E E E E E E E E E E E E E E E E E E E E E E E E E E E E E W F F F F F F F W E E E E E E E E E 
E E E E E E E E E E E E E E E E E E E E E E E E E E E E E E E E E E E E E E E E E E E E E E E E E E E E E E E E E W F F F F F F F W E E E E E E E E E 
E E E E E E E E E E E E E E E E E E E E E E E E E E E E E E E E E E E E E E E E E E E E E E E E E E E E E E E E E W F F F F F F F W E E E E E E E E E 
E E E E E E E E E E E E E E E E E E E E E E E E E E E E E E E E E E E E E E E E E E E E E E E E E E E E E E E E E W F F F F F F F W E E E E E E E E E 
E E E E E E E E E E E E E E E E E E E E E E E E E E E E E E E E E E E E E E E E E E E E E E E E E E E E E E E E E W F F F F F F F W E E E E E E E E E 
E E E E E E E E E E E E E E E E E E E E E E E E E E E E E E E E E E E E E E E E E E E E E E E E E E E E E E E E E W F F F F F F F W E E E E E E E E E 
E E E E E E E E E E E E E E E E E E E E E E E E E E E E E E E E E E E E E E E E E E E E E E E E E E E E E E E E E W W W W W W W W W E E E E E E E E E 
E E E E E E E E E E E E E E E E E E E E E E E E E E E E E E E E E E E E E E E E E E E E E E E E E E E E E E E E E E E E E E E E E E E E E E E E E E E 

